0 0 0 0 0 0 0 0 0 0 0 0 0 0 0 0 0
0 0 0 0 0 0 0 0 0 0 0 0 0 0 0 0 0
0 0 0 0 0 0 0 0 0 0 0 0 0 0 0 0 0
0 0 0 0 0 0 0 0 0 0 0 0 0 0 0 0 0
0 0 0 0 0 0 0 0 0 0 0 0 0 0 0 0 0
0 0 0 0 0 0 0 0 0 0 0 0 0 0 0 0 0
0 0 0 0 0 0 0 0 0 0 0 0 0 0 0 0 0
0 0 0 1 1 0 0 1 0 0 0 0 0 1 1 0 0
0 0 0 1 1 1 0 0 2 2 1 0 0 1 0 0 1
1 1 0 1 1 1 1 1 0 2 1 0 1 1 0 0 0
0 0 1 0 0 1 0 0 0 1 0 0 0 0 0 0 0
0 0 1 0 0 0 1 1 0 0 0 1 1 0 0 0 1
0 0 0 0 0 0 0 0 1 1 0 0 0 0 0 0 0
1 0 0 0 0 0 1 0 0 0 0 1 0 0 0 0 1
0 1 0 0 1 1 0 0 1 1 1 0 0 0 1 0 1
0 0 0 0 1 0 0 0 1 1 1 0 0 0 0 0 0
0 1 0 0 1 0 0 0 1 0 1 0 0 0 0 1 0
8 8
8 9
